111111
101C11
101011
1P1E11
111111