1111111111111111111111111111111111
1000C00C0000000000C000000000000001
10000F00C11111100000FC0000C0100C01
10000C000000C11111C00000F00010C001
1111100C00100000011110C1C01110C001
10000C000F100100CCC000000C00000001
10001111111111110000C0C000010010C1
10000000011C0100100C0C000F00001C01
1C11110001C0010010000F000010C00011
1000C1110100010011110001C000111111
1C0100100000000010000P0C1100C000E1
1111111111111111111111111111111111