11111111111
1C0C0C0C0C1
11111011111
10FC0C0CF01
11111011111
1E000F000C1
11111011111
1C0C0P0C0C1
11111111111