1111111111111
1C010000000C1
1000011111001
1P0C11E000001
10010110000C1
1C01001100001
1C010000000C1
1111111111111