1111111111111111111111111111111111
1101000000000000000000000100000001
1110000100000000000000000001000001
1000100010110000010C10011000000101
10101000000001C0001010000000000101
10110E1001101000000000000000100001
11000010000100001000110C000C100001
1001C100000000000000010000100C0001
10000CC100P00000000111000000100011
1000110101000000010000100010000001
1000000000000010000001000010000001
1111111111111111111111111111111111