1111111111111
1C010000000C1
1000011111001
1P0C11E00F001
1001C110000C1
1C01001100F01
1C0100F0000C1
1111111111111