1111111111111111111111111111111111111111
1000C000001000000C0000100000100000001011
100000000010000100000110010000000110C001
10C0000000000000101011001100010000C00001
1010000010000101010000000000000010000001
1000000000100100C001100000001C0000000001
10000000000000001C1000000000001000000001
11000C0010000000100001000000010100000011
10000000001000100100100101000P0100000001
10010000C101000000100C100000101000000001
110100000000000000000000C000001000100001
10EC00000000C1000000C1000C0100110000C001
1010000010C0000000C00000010C000100100001
10000001000010C00000000000000101C0110001
1000C00100000100000001010000010100010101
1010000000000000110C00000000010000000001
1000000010000000000101100000000000000001
1111111111111111111111111111111111111111