1111111111111111111111111111111111
100000000000000000C000000000000001
100000000000010000000C000000000001
100000000000000001C000000000000001
1000000C00000000000000000000000001
1000000000000000000000000C00000001
10001000000000000000000000010000C1
10000000001C0000000C0C000000000001
1C00000000C00000000000000010C00001
1000C00000000000000000000000000001
100000E00000000000000P0C0000000001
1111111111111111111111111111111111