1111111111111111
100000000000C001
1010000000000001
10000C00101000C1
10000100000000C1
1000000000000011
1000000000001001
1100000000CC0001
100000000000P0C1
1000000000000001
1010000000000001
100000E000000001
1000000000000001
10000000C0000001
1111111111111111