11111
100C1
10EK1
1P001
10001
11111