11111
10001
10E01
100P1
10001
11111