11E11
100C1
10E01
1P001
10001
11111