11111
100C1
10E01
1P0P1
10001
11111